733336A7333
A73360A0733
AA76AAAA073
000AA0000A7
AA0AA000000
AA00000AAA0
4AAAA00AAAA
3400A0000A0
3340A00AAA5
3334A000A53
3333400A533